NO ./textures/n_wall.xmp
SO ./textures/e_wall.xmp
WE ./textures/s_wall.xmp
EA ./textures/west_wall.xmp

F 220,100,0
C 225,30,0

1111111111
1110N11101
1111111111
