NO ./textures/blue_wall.xpm
SO ./textures/green_wall.xpm
WE ./textures/red_wall.xpm
EA ./textures/yellow_wall.xpm

F 220,100,0
C 225,30,0

1111111111
1000000001
1110N11101
1000000001
1111111111
